
vous pouvez ecrire avant l'asterix
la map commence a la ligne en dessous de l'asterix et finit a la prochaine asterix
map en 50 (y)     par 100 (x)

P
D
Y
W

*
WWWWWWWWWWWWWWWWWWWWWWWWWWWWWWWWWWWWWWWWWWWWWWWWWWWWWWWWWWWWWWWWWWWWWWWWWWWWWWWWWWWWWWWWWWWWWWWWWWWW
W--------------------------------------------------------------------------------------------------W
W--FINISH------------------------------------------------------------------------------------------W
W--------------------------------------------------------------------------------------------------W
W--------------------------------------------------------------------------------------------------W
WWWWWWWWW------------------------------------------------------------------------------------------W
--------W------------------------------------------------------------------------------------------W
--------W------------------------------------------------------------------------------------------W
--------W------------------------------------------------------------------------------------------W
-------WPW-----------------------------------------------------------------------------------------W
------WP-PW----------------------------------------------------------------------------------------W
-----W-----W-----------------------W---W---W---W---W---W---W---------------------------------------W
-----W-----W---------------------------------------------------------------------------------------W
-----W--W--W---------------------------------------------------------------------------------------W
-----W-WWW-W---------------------------------------------------------------------------------------W
-----W-----W-----------------------W-----------W-----------W---------------------------------------W
-----W-----W----------------------------------W-W--------------------------------------------------W
-----WWW-WWWWWWWWWW--------------------------W---W-------------------------------------------------W
-----W------------W-------------------------W-----W------------------------------------------------W
-----W---WWWWWWW--W----------------W-------W-------W-------W---------------------------------------W
-----W---W----WW--W-------------------------W-----W------------------------------------------------W
WWWWWWWWWWWW--WW--W--------------------------W---W-------------------------------------------------W
W----------W--WW--W---------------------------W-W--------------------------------------------------W
WWWWWW-----W--WW--W----------------W-----------W-----------W---------------------------------------W
W----------W------W--------------------------------------------------------------------------------W
W-START----Y------W--------------------------------------------------------------------------------W
W----------W------W--------------------------------------------------------------------------------W
WWWWWW-----W------W----------------W---W---W---W---W---W---W---------------------------------------W
WP---------W------W--------------------------------------------------------------------------------W
WWWWWWWWWWWWWWWDWWW--------------------------------------------------------------------------------W
W----------W------W--------------------------------------------------------------------------------W
W----------Y------W--------------------------------------------------------------------------------W
W----------W------W--------------------------------------------------------------------------------W
W---WWWWWWWWWWWWWWW--------------------------------------------------------------------------------W
W---W-------------W--------------------------------------------------------------------------------W
W---W-------------Y--------------------------------------------------------------------------------W
W---W-------------W--------------------------------------------------------------------------------W
W---W--AMMO----WWWWWWWWWWWWWWWWWWWWWWWWWWWWWWWWWWWWWWWWWWWWWWWWWWWWWWWWWWWWDWWWWWWWWWWWWWWWWWWWWWWWW
W---W----------WP------------WWWW-------------PW-------W---------W-------------------W--------------
W---W----------W-------------WWWW--------------W-------W---------W-------------------W--------------
W---W----------W-------------------------------W-------------W---W-------------------W--------------
W---WWWWWWWWWWWW------W----------------W-------W-------------W---W-------------------W--------------
W--------------W-------------------------------W----WWWWWWWWWWWDWWWDWWWWWWWWWW-------W--------------
W--------------Y-------------------------------Y----W------------------------WWWWDWWWW--------------
W--------------W-------------------------------W----WWWWWWWWWWWWWWWWWWWWWWWWWW-------W--------------
WWWWWWWWWWWWWWWW-------------------------------W------------W----------W-------------W--------------
---------------W------W----------------W-------W------------W----------W-------------W--------------
---------------W-------------WWWW--------------W-------W---------W-------------------W--------------
---------------WP------------WWWW-------------PW-------W---------W-------------------W--------------
---------------WWWWWWWWWWWWWWWWWWWWWWWWWWWWWWWWWWWWWWWWWWWWWWWWWWWWWWWWWWWWWWWWWWWWWWW--------------